#########################################
#A#         #   #     #         # #     #
# ####### # # # # ### # ### ### # # # # #
#       # #   #   # # #   # #   #   # # #
####### # # #######   ### # # ### ### # #
#   #   # #         #     # #   #   # # #
# ### # # ####### # ####### ### # ###   #
#     #   #     # #     #     # # #   # #
# ####### # ### # ##### # # # # # # ### #
# # #     #   # # #   #   # # # # # #   #
# # # # ### # # # # # ##### ### ### ### #
# #   # #   # # # # # #   #   #   #   # #
# # ### ### # # # # # # # ### ### ### ###
# #   #   # #       #   #     # #   #   #
# # #  ## # # ########### ### # ### # # #
#   #   # #     #   #           #   # # #
### # # # # ##  # # ### #### # ## ### # #
# # # #   #   #   #   #           #   # #
# # ### ##### ####### ####  ####### # # #
#       #           #               #  B#
#########################################