###############################
#A      #   #         #       #
####### # # # ####### # ### ###
#       # # #     #   #   #   #
# ####### # ##### # ######### #
# #     # #   #   #   #     # #
# ### # # ### # ##### # ### # #
#     #   # #   #   #   # # # #
########### ##### # ##### # # #
#     #   #       #       #   #
# ### # # # # ######### ##### #
# # #   # # #   #       #   # #
# # ##### # ### ######### # # #
#       #     #           #  B#
###############################