###############
#A    #       #
##### # ##### #
#   # #   #   #
### # ### # # #
#   #   # # # #
# ##### ### # #
#           #B#
###############