#####################
#A#         #       #
# #### ## # # ### ###
#       # #     #   #
# ##### #  ###  ### #
#   #   #     #   # #
# ##  ##### ### # # #
#     #   #     #   #
# ##### # #######   #
#       #         #B#
#####################