#################################
#A#           #       #   #     #
# ### #######   ##### # # # ### #
#     #   # # #     #   #     # #
####### # # # # ### ## #####  # #
#     # # # # #   #         #   #
# ### # # # # # # ########  #####
# # #   # # # # #         # #   #
# # #   # # # ### ####### # # # #
# #     #   #     #       #   # #
# ############ #### ####### # # #
#     #     #         #       # #
##### # ### # # ####  # # ### # #
#     # #   # # #   #   #   # # #
# # ### # ### # #   ####### ### #
#             #   #            B#
#################################